10 x 30
*****O**************O*********
*                            *
*  R   **   **    *   **  R  *
*      *          **    *    *
*    **    H       *   R     O
*R   * *         *           *
*      **           ***      *
*    R     *                 *
*          **     *     R    *
********************O*********