15 x 20
***********O********
*                  *
*  R      R     R  *
*                  *
*  ***         *** *
*      *   **      *
*    H           R *
*          **      *
*        *         O
*                  *
*  * **       * ** *
*                  *
*  R      R        *
*                  *
******O**********O**